NO ./textures/brick/yellow_brick.xpm
SO ./textures/brick/blue_brick.xpm
WE ./textures/brick/grey_brick.xpm
EA ./textures/brick/purple_brick.xpm

1111111111111111111111
1000000000000000000001
1000000100000000N11111
111111111111111111
