F 0,0,0

C 0,0,153

1111111111111111111111
1000000000000000000001
1000000100000000N11111
111111111111111111
