NO ./textures/brick/yellow_brick.xpm
SO ./textures/brick/blue_brick.xpm
WE ./textures/brick/grey_brick.xpm
EA ./textures/brick/purple_brick.xpm

F 87,108,67
C 98,122,157

              11111111111111111111111111
            110000000000000000000000000011
          1100000000111111111111110000000011
        11000000001100000000000000110000000011
      110000000011000011111111100000110000000011
    1100000000110000110000000000110000110000000011
  11000000000100001100001111110000110000110000000011
11E000000011000011000011000000110000110000110000000011
  11000000001100001100000111110000110000110000000011
    1100000000110000110000000000110000110000000011  
      110000000011000011111111110000110000000011
        11000000001100000000000000110000000011
          1100000000111111111111110000000011
            110000000000000000000000000011
              11111111111111111111111111
