111111111111
100001000001
100001000001
1000000W0001
100000001001
111111111111
