NO ./textures/lucas.xpm
SO ./textures/ana.xpm
WE ./textures/white42.xpm
EA ./textures/cyan42.xpm
F 119,119,119
C 0,0,255

11111111111111
10000100000001
10000100000001
1000000N000001
10000000000001
10000000100001
11111111111111
