11111111111111
10000100000001
10000100000001
1000000W000001
10000000000001
10000000100001
11111111111111
